NO ./textures/path_to_the_north_texture

SO ./textures/path_to_the_south_texture


F 220,100,0
EA ./textures/path_to_the_east_texture

WE ./textures/path_to_the_west_texture
C 225,30,0

s
  1111111111111111111111111111
  1111110110000110000000000000111
  10010000000000000000000001111
1111111111100000111000000000000001
1000000000110000011101111111111111

11110111111111011100000010001
11110111111111011111010010001
110000001101011 1000001000111
100000000000011111110000010001
10000000000000101101010010001
11000001110101011111011110N0111
11110111 1110101 101111010001
11111111 1111111 111111111111
