NO ./textures/path_to_the_north_texture
SO ./textures/path_to_the_south_texture
EA ./textures/path_to_the_east_texture
WE ./textures/path_to_the_west_texture
C 225,30,0
F 225,255,0






              1111 
              10S1 
              1111