EA ./textures/MiConv.com__TECH_2F.xpm
WE ./textures/MiConv.com__TECH_4E.xpm
SO ./textures/MiConv.com__CRATE_2C.xpm
NO ./textures/MiConv.com__CONSOLE_1B.xpm

C 117, 2, 0
F 33, 26, 26

		1111111111111111111111111
		1000000000110000000000001
		101100000111000000S000001
		100100000000000D000000001
111111111011000001110000000000001
100000000011000001110111111111111
11110111111111011100000010001
11110111111111011101010010001
11000000110101011100000010001
10000000000000001100000010001
10000000000000001101010010001
110000011101010111110111100111
11110111 1110101 10111101000101
11111111 1111111 1111111111111
