NO ./textures/path_to_the_north_texture
SO ./textures/path_to_the_south_texture
EA ./textures/path_to_the_east_texture
WE ./textures/path_to_the_west_texture

C 225,30,0
F 225,30,0

    11111111111111111111111111111111
   11 101110110000110000000000001101
     11001000000000000000000001111111
1111111111100000111000000000000001
1000000000110000011101111111111111
11110111111111011100000010001
11110111111111011111010010001
110000001101011 1000001000111
100000000000011111110000010001
100000000000001011010100100011
110000011101010111110111100110111       
11110111 1110101 1011110100S11
11111111 1111111 1111111111111

