NO ./textures/path_to_the_east_texture.xpm
SO ./textures/path_to_the_north_texture.xpm
EA ./textures/path_to_the_east_texture.xpm
WE ./textures/path_to_the_north_texture.xpm

C 225,30,0
F 225,255,0

    111111111111111111111111111111
    111011101100001100000000000011
    110010000000000000000000011111
1111111111100000111000000000000001
1000000000110000011101111111111111
11110111111111011100000010001
11110111111111011111010010001
110000001101011 1000001000111
100000000000011111110000010001
100000000000001011010100100011
1100000111010101111101111001101
11110111 1110101 1011110100S11
11111111 1111111 1111111111111 