EA ./textures/east_texture.xpm
WE ./textures/west_texture.xpm
NO ./textures/north_texture.xpm
SO ./textures/south_texture.xpm

C 0,0,0
F 0,0,0

		1111111111111111111111111
		10D0000000110000000000001
		101100000111000000W000001
		10010000000D0000000000001
111111111011000001110000000000001
100000000011000001110111111111111
1111011111  11111   11 111
111101111111111111111111111111
11110111111111011100000010001
1111D111111111011101010010001
11000000110101011100000000001
1000000000000000D000000010001
10000000000000001101010010001
110000011101010111110111100111
11110111 1110101 10111101000101
11111111 1111111 1111111111111
