EA ./textures/b_1.xpm
WE ./textures/b_2.xpm
NO ./textures/b_3.xpm
SO ./textures/b_4.xpm

C 0,0,0
F 0,0,0

111111
1E001
111111