EA ./textures/b_1.xpm
WE ./textures/b_2.xpm
NO ./textures/b_3.xpm
SO ./textures/b_4.xpm

C 0,0,0
F 0,0,0

111111111111111111111111111111111111111111
1E00D0000001000000000000000000000000000001
111111111001000000000000000000000000000101
10000000D001000000000000000000000000000101
100000001001000000000000000000000000000101
100000001001000000000000000000000000000101
1000000011D1000000000000000000000000000101
100000001101111111000000000000000000000101
100000001000000001000000000000000000000101
100000001111D111D1111111111111111111111101
100000000000000100000000000000000000000001
111111111111111111111111111111111111111111