EA ./textures/path_to_the_east_texture.xpm
WE ./textures/path_to_the_north_texture.xpm
C 225,30,0
F 225,30,0
SO ./textures/path_to_the_north_texture.xpm
NO ./textures/path_to_the_east_texture.xpm

111111111111111111111111111111111111111111
100001100001100001100001100001100001100001
100000000000000000000000000000000000000001
100000000000000000000000000000000000000001
100000000000000000000000000000000000000001
100000000000000000000000000000000000000001
100000000000000000000000000000000000000001
100000000000000000000000000000000000000001
100000000000111111100000000000000000000001
100000000000111111100000000000000000000001
100000000000000000000000000000000000000001
100000000000000000000000000000000000000001
100000000000000000000001000000000000000001
100000000000000000000000100000000000000001
100000000000000000000000000000000000000001
100000000000000000000100000000000000000001
100000000000000000001000000000000000000001
100000000000000000000000000000000000000001
100000000000000000000000000000000000000001
100000000000000N00000000000000000000000001
100000000000000000000000000000000000000001
100000000000000000000000000000000000000001
100000000000000000111111100000000000000001
100000000000000000111111100000000000000001
100000000000000000000000000000000000000001
100000000000000000000000000000000000000001
100000000000000000000000000000000000000001
111111111111111111111111111111111111111111