EA ./textures/MiConv.com__BRICK_3B.xpm
WE ./textures/MiConv.com__BRICK_6D.xpm
SO ./textures/MiConv.com__BRICK_2B.xpm
NO ./textures/MiConv.com__BRICK_1A.xpm

C 117, 2, 0
F 33, 26, 26


111111111111111111111111111111111111111111
100001100001100001100001100001100001100001
100000000000000000000000000000000000000001
100000000000000000000000000000000000000001
100000000000111111100000000000000000000001
1000000000001111111000000000W0000000000001
100000000000000000000000000000000000000001
100000000000000000000001D10000000000000001
100000000000000000000000000000000000000001
100000000000000000000000000000000000000001
100000000000000000000000000000000000000001
100000000000000000111111100000000000000001
100000000000000000111111100000000000000001
100000000000000000000000000000000000000001
100000000000000000000000000000000000000001
111111111111111111111111111111111111111111