EA ./textures/east_texture.xpm
WE ./textures/west_texture.xpm
NO ./textures/north_texture.xpm
SO ./textures/south_texture.xpm

F 28,28,28
C 20,20,20

     1111    11
11111000011110011
10000000000000111
10000000000001
111000000000011
   100000000001
   1000000000001
   100000N0000001
  10000000000001
 10000000000001
 1000000000001
 1111100000001
      10000001                 111111
     10000001                 10000001
   110000001                  10011001
  10000001111111111           101  101
  111000000000000011111       101  101
     100000000000000001111111110011001
      10001111111100000000000000000001
       10001      1111111111111111111
        10001
         10001
     111100001
     100000001
     101111101
     101000101
     101011101
     100000001
      1111111